#####
#   #
# # #
# # #
#####
